33333333333
31111211003
31201210203
31011011013
31110101113
32201110223
30110101103
31011011013
30201210213
30010201113
33333333333