33333333333
30211210003
32221200203
31211010003
31110101013
32201110223
30110101103
30011011213
30201212223
30000201203
33333333333