33333333333
30001210003
30200200203
30001010003
31010101013
32201110223
30110101103
30011011213
30201212223
30000201203
33333333333