33333333333
30001210003
30200200203
30001010003
31010101013
32201110223
30110101013
30011010003
30201200203
30000210003
33333333333